
{
  "ground": {
    "symbols": {
      "=" : {"class": "${default}.gamehex.staticitems.Ground"},

      "#" : {"class": "${default}.gamehex.staticitems.Ground", "id": "clifftop"},
//      "#": {
//        "class": "${default}.gamehex.staticitems.CustomStaticItem",
//        "images": [
//          "cliff-background-1/cliff-background-1-full"
//        ],
//        "id": "clifftop",
//        "transform": "none",
//        "passable": false
//      },
      "Ø": {
        "class": "${default}.gamehex.staticitems.AutoEdge",
        "innerTypeId": "clifftop",
        "background": "grounddirt",
//        "innerBackgroundLocation": "cliff-background-1",
        "location": "cliff2"
      },
      "X" : {
        "class": "${default}.gamehex.staticitems.AutoWall",
        "background": "grounddirt",
        "location": "wall3"
      },
      "s" : {
        "class": "${default}.gamehex.staticitems.CustomStaticItem",
        "images": ["grounddirt","sentinel"],
        "transform": "none",
        "passable": false
      },
      "h" : {
        "class": "${default}.gamehex.staticitems.CustomStaticItem",
        "images": ["grounddirt","striverhammer"],
        "transform": "none",
        "passable": false
      }
    },
    "map": [
      "= = = = = = = = = = = = = Ø # # # Ø = = = = = = = = = = = = =",
      " = = = = = = = = = = = = = Ø # # # Ø = = = = = = = = = = = = ",
      "= = = = = = = = = = = = = = Ø # # Ø = = = = = = = = = = = = =",
      " = = = s h = = = = = = = = = Ø # # Ø = = = = = = = = = = = = ",
      "= = = = = = = = = = = = = = Ø # # Ø = = = = = = = = = = = = =",
      " = = = = = = = = = = = = = Ø # # Ø = = = = = = = = = = = = = ",
      "= = = = = = = = = = = = = = Ø # Ø = = = = = = = = = = = = = =",
      " = = = = = = = = = = = = = Ø # # Ø = = = = = = = = = = = = = ",
      "= = = = = = = = = = = = Ø Ø # # # Ø = = = = = = = = = = = = =",
      " = = = = = = = = = = = Ø # # # # # Ø Ø = = = = = = = = = = = ",
      "= = = = = = = = = = = Ø # # # # # # # Ø Ø = = = = = = = = = =",
      " = = = = = = = = = = = Ø # Ø Ø Ø # # # # Ø = = = = = = = = = ",
      "= = = = = = = = = = = Ø # Ø = = Ø # # # Ø = = = = = = = = = =",
      " = = = = = = = = = = = Ø Ø = = = Ø # # Ø = = = = = = = = = = ",
      "= = = = = = = = = = = = = = = = = Ø Ø Ø = = = = = = = = = = =",
      " = = = = = = = = = = = = = = = = = = = = = = = = = = = = = = ",
      "= = = = = = = = = = = = = = = = = = = = = = = = = = = = = = =",
      " = = = = = = = = = = = = = = = = = = = = = = = = = = = = = = ",
      "= = = = = = = = = = = = = = = = Ø Ø = = = = = = = = = = = = =",
      " = = = = = = = = = = = = = = = Ø # Ø = = = = = = = = = = = = ",
      "= = = = = = = = = = = = = = = = Ø # Ø = = = = = = = = = = = =",
      " = = = = = = = = = = = = = = = Ø # Ø = = = = = = = = = = = = ",
      "= = = = = = = = = = = = = = = = Ø # Ø = = = = = = = = = = = =",
      " = = = = = = = = = = = = = = = Ø # Ø = = = = = = = = = = = = ",
      "= = = = = = = = = = = = = = = Ø # # Ø = = = = = = = = = = = ="
    ]
  },
  "other": {
    "symbols": {
      "w" : {"class": "${default}.gamehex.other.Fire"},
      "§" : {"class": "${default}.gamehex.other.LiveFirePlant"},
      "/" : {"class": "${default}.gamehex.other.DeadFirePlant"},
      "#" : {"class": "${default}.gamehex.other.Brick"},
      "O": {
        "class": "${default}.gamehex.other.DroppedItemInteractor",
        "imageName": "boulder/boulder",
        "passable": true,
        "itemType": "avividi.com.monuments.controller.item.BoulderItem"
      }
    },
    "map": [
      "+ O O + O + + + + + + + + + + + + + § § § § § + + + + + + + +",
      " + O O O O + O + + + + + + + + + + + § + § § § + + + + + + + ",
      "O O O + O + + + + + § + O O + + § + + + + + § § + + + + + + +",
      " + O O + + O O + + + O O O O + § + + + + + § + + + + + + + + ",
      "O O O O + + + + + O + O O O + + + + + § + + + + + + + + + § +",
      " O + O + + + + + + + + + O + + + + + + + + + + + + + + + § § ",
      "+ + + + + + O O + + + + + + + + + + + + + + + + + + + + + § §",
      " + § + + § + O O O O + + + + + + + + + + + + + + + + + + + § ",
      "§ § + + + + + + + O O + + + + + + + + O O + + + + + + + + + +",
      " § + + + + + + + + O + + + + + + + + + + + + + + + + + + + + ",
      "§ + + + + + + + + + + + + + + + + + + + + O + + + + + + + + +",
      " + + + + + + + + + + + + + + + + + § + + + + + + + + + + + + ",
      "+ + + + + + + + + + + + + + O O + + + + + + + + + + + + + + +",
      " + § § O + + + + + + + + + + + + + + + + + + + + + + + + + + ",
      "+ + § § + + + + + + + + + + + + + + + + + + + + + + + + + + +",
      " + § § + + + + + + + + + + + + + + + + + + + + + + + + + + + ",
      "+ + § + + + + + + + + + + + + + + + + + + + + + + § + + + + +",
      " + + + O O + + + + + + + + + + + + + + + + + + + § § + + § § ",
      "+ + + + O + + + + + + + + + + + + + + + + + + + + § + + + § §",
      " + + + O O + + + + + + + + + § + + + + + + + + + § § + + § § ",
      "+ + + + + + + + + + + + + + + + + + + + O + + + + + + + + § §",
      " + + + O + + + + + + + + + + + + + + + + + + + + § § + + § § ",
      "+ + + + + + + + + + O O + + + + + + + + + + + + § § § + + + §",
      " § + + + + + § + + + O O + + + + + + + + + O + + § + + + + § ",
      "§ + § + + + + + + + + + + + + + + + + + + + + + + + + + + + +"
    ]
  },
  "units": {
    "symbols": {
      "S" : {"class": "${default}.gamehex.unit.Maldar"}
    },
    "map": [
      "+ + + + + + + + + + + + + + + + + + + + + + + + + + + + + + +",
      " + + + + + + + + + + + + + + + + + + + + + + + + + + + + + + ",
      "+ + + + + + + + + + + + + + + + + + + + + + + + + + + + + + +",
      " + + + + + + + + + + + + + + + + + + + + + + + + + + + + + + ",
      "+ + + + + + + + + + + + + + + + + + + + + + + + + + + + + + +",
      " + + + + + + + + + + + + + + + + + + + + + + + + + + + + + + ",
      "+ + + + + + + + + + + + + + + + + + + + + + + + + + + + + + +",
      " + + + + + + + + + + + + + + + + + + + + + + + + + + + + + + ",
      "+ + + + + + + + + + + + + + + + + + + + + + + + + + + + + + +",
      " + + + + + + + + + + + + + + + + + + + + + + + + + + + + + + ",
      "+ + + + + + + + + + + + + + + + + + + + + + + + + + + + + + +",
      " + + + + + + + + + + + + + + + + + + + + + + + + + + + + + + ",
      "+ + + + + + + + + + + + + + + + + + + + + + + + + + + + + + +",
      " + + + + + + + + + + + + + + + S + + + + + + + + + + + + + + ",
      "+ + + + + + + + + + + + + + S + + + + + + + + + + + + + + + +",
      " + + + + + + + + + + + + + + + + + + + + + + + + + + + + + + ",
      "+ + + + + + + + + + + + S + + + + + + + + + + + + + + + + + +",
      " + + + + + + + + + + + + + + + + + + + + + + + + + + + + + + ",
      "+ + + + + + + + + + + + + + + + + + + + + + + + + + + + + + +",
      " + + + + + + + + + + + + + + + + + + + + + + + + + + + + + + ",
      "+ + + + + + + + + + + + + + + + + + + + + + + + + + + + + + +",
      " + + + + + + + + + + + + + + + + + + + + + + + + + + + + + + ",
      "+ + + + + + + + + + + + + + + + + + + + + + + + + + + + + + +",
      " + + + + + + + + + + + + + + + + + + + + + + + + + + + + + + ",
      "+ + + + + + + + + + + + + + + + + + + + + + + + + + + + + + +"
    ]
  }
}