
{
  "ground": {
    "symbols": {
      "=" : {"class": "${default}.gamehex.staticitems.Ground"},
      "#": {
        "class": "${default}.gamehex.staticitems.CustomStaticItem",
        "images": [
          "cliff1/cliff1-full"
        ],
        "transform": "none",
        "passable": false
      },
      "Ø": {
        "class": "${default}.gamehex.staticitems.AutoEdge",
        "innerEdgeFirstImage": "cliff1/cliff1-full",
        "background": "grounddirt",
        "location": "wall1"
      },
      "X" : {
        "class": "${default}.gamehex.staticitems.AutoWall",
        "background": "grounddirt",
        "location": "wall3"
      },
      "s" : {
        "class": "${default}.gamehex.staticitems.CustomStaticItem",
        "images": ["grounddirt","sentinel"],
        "transform": "none",
        "passable": false
      }
    },
    "map": [
      "= = = = = = = = = = = = = Ø # # # Ø = = = = = = = = = = = = =",
      " = = = = = = = = = = = = = Ø # # # Ø = = = = = = = = = = = = ",
      "= = = = = = = = = = = = = = Ø # # Ø = = = = = = = = = = = = =",
      " = = = s = = = = = = = = = = Ø # # Ø = = = = = = = = = = = = ",
      "= = = = = = = = = = = = = = Ø # # Ø = = = = = = = = = = = = =",
      " = = = = = = = = = = = = = Ø # # Ø = = = = = = = = = = = = = ",
      "= = = = = = = = = = = = = = Ø # Ø = = = = = = = = = = = = = =",
      " = = = = = = = = = = = = = Ø # # Ø = = = = = = = = = = = = = ",
      "= = = = = = = = = = = = Ø Ø # # # Ø = = = = = = = = = = = = =",
      " = = = = = = = = = = = Ø # # # # # Ø Ø = = = = = = = = = = = ",
      "= = = = = = = = = = = Ø # # # # # # # Ø Ø = = = = = = = = = =",
      " = = = = = = = = = = = Ø # Ø Ø Ø # # # # Ø = = = = = = = = = ",
      "= = = = = = = = = = = Ø # Ø = = Ø # # # Ø = = = = = = = = = =",
      " = = = = = = = = = = = Ø Ø = = = Ø # # Ø = = = = = = = = = = ",
      "= = = = = = = = = = = = = = = = = Ø Ø Ø = = = = = = = = = = =",
      " = = = = = = = = = = = = = = = = = = = = = = = = = = = = = = ",
      "= = = = = = = = = = = = = = = = = = = = = = = = = = = = = = =",
      " = = = = = = = = = = = = = = = = = = = = = = = = = = = = = = ",
      "= = = = = = = = = = = = = = = = Ø Ø = = = = = = = = = = = = =",
      " = = = = = = = = = = = = = = = Ø # Ø = = = = = = = = = = = = ",
      "= = = = = = = = = = = = = = = = Ø # Ø = = = = = = = = = = = =",
      " = = = = = = = = = = = = = = = Ø # Ø = = = = = = = = = = = = ",
      "= = = = = = = = = = = = = = = = Ø # Ø = = = = = = = = = = = =",
      " = = = = = = = = = = = = = = = Ø # Ø = = = = = = = = = = = = ",
      "= = = = = = = = = = = = = = = Ø # # Ø = = = = = = = = = = = ="
    ]
  },
  "other": {
    "symbols": {
      "w" : {"class": "${default}.gamehex.other.Fire"},
      "§" : {"class": "${default}.gamehex.other.FirePlant"},
      "#" : {"class": "${default}.gamehex.other.Brick"},
      "O": {
        "class": "${default}.gamehex.other.DroppedItemInteractor",
        "imageName": "boulder/boulder",
        "passable": true,
        "itemType": "avividi.com.monuments.controller.item.BoulderItem"
      }
    },
    "map": [
      "+ + + + + + + + + + + + + + + + + + § § § § § + + + + + + + +",
      " + + + + + + + + + + + + + + + + + + § + § § § + + + + + + + ",
      "+ + O + + + + + + + § + O O + + § + + + + + § § + + + + + + +",
      " + O O + + + + + + + O O O O + § + + + + + § + + + + + + + + ",
      "+ + O O + + + + + O + O O O + + + + + § + + + + + + + + + § +",
      " + + O + + + + + + + + + O + + + + + + + + + + + + + + + § § ",
      "+ + + + + + O O + + + + + + + + + + + + + + + + + + + + + § §",
      " + § + + + + O O O O + + + + + + + + + + + + + + + + + + + § ",
      "§ § + + + + + + + O O + + + + + + + + O O + + + + + + + + + +",
      " § + + + + + + + + O + + + + + + + + + + + + + + + + + + + + ",
      "§ + + + + + + + + + + + + + + + + + + + + O + + + + + + + + +",
      " + + + + + + + + + + + + + + + + + § + + + + + + + + + + + + ",
      "+ + + + + + + + + + + + + + O O + + + + + + + + + + + + + + +",
      " + § § O + + + + + + + + + + + + + + + + + + + + + + + + + + ",
      "+ + § § + + + + + + + + + + + + + + + + + + + + + + + + + + +",
      " + § § + + + + + + + + + + + + + + + + + + + + + + + + + + + ",
      "+ + § + + + + + + + + + + + + + + + + + + + + + + § + + + + +",
      " + + + O O + + + + + + + + + + + + + + + + + + + § § + + § § ",
      "+ + + + O + + + + + + + + + + + + + + + + + + + + § + + + § §",
      " + + + O O + + + + + + + + + + + + + + + + + + + § § + + § § ",
      "+ + + + + + + + + + + + + + + + + + + + O + + + + + + + + § §",
      " + + + O + + + + + + + + + + + + + + + + + + + + + + + + + § ",
      "+ + + + + + + + + + O O + + + + + + + + + + + + + + + + + + §",
      " § + + + + + § + + + O O + + + + + + + + + O + + + + + + + § ",
      "§ + § + + + + + + + + + + + + + + + + + + + + + + + + + + + +"
    ]
  },
  "units": {
    "symbols": {
      "S" : {"class": "${default}.gamehex.unit.Maldar"}
    },
    "map": [
      "+ + + + + + + + + + + + + + + + + + + + + + + + + + + + + + +",
      " + + + + + + + + + + + + + + + + + + + + + + + + + + + + + + ",
      "+ + + + + + + + + + + + + + + + + + + + + + + + + + + + + + +",
      " + + + + + + + + + + + + + + + + + + + + + + + + + + + + + + ",
      "+ + + + + + + + + + + + + + + + + + + + + + + + + + + + + + +",
      " + + + + + + + + + + + + + + + + + + + + + + + + + + + + + + ",
      "+ + + + + + + + + + + + + + + + + + + + + + + + + + + + + + +",
      " + + + + + + + + + + + + + + + + + + + + + + + + + + + + + + ",
      "+ + + + + + + + + + + + + + + + + + + + + + + + + + + + + + +",
      " + + + + + + + + + + + + + + + + + + + + + + + + + + + + + + ",
      "+ + + + + + + + + + + + + + + + + + + + + + + + + + + + + + +",
      " + + + + + + + + + + + + + + + + + + + + + + + + + + + + + + ",
      "+ + + + + + + + + + + + + + + + + + + + + + + + + + + + + + +",
      " + + + + + + + + + + + + + + + S + + + + + + + + + + + + + + ",
      "+ + + + + + + + + + + + + + S + + + + + + + + + + + + + + + +",
      " + + + + + + + + + + + + + + + + + + + + + + + + + + + + + + ",
      "+ + + + + + + + + + + + S + + + + + + + + + + + + + + + + + +",
      " + + + + + + + + + + + + + + + + + + + + + + + + + + + + + + ",
      "+ + + + + + + + + + + + + + + + + + + + + + + + + + + + + + +",
      " + + + + + + + + + + + + + + + + + + + + + + + + + + + + + + ",
      "+ + + + + + + + + + + + + + + + + + + + + + + + + + + + + + +",
      " + + + + + + + + + + + + + + + + + + + + + + + + + + + + + + ",
      "+ + + + + + + + + + + + + + + + + + + + + + + + + + + + + + +",
      " + + + + + + + + + + + + + + + + + + + + + + + + + + + + + + ",
      "+ + + + + + + + + + + + + + + + + + + + + + + + + + + + + + +"
    ]
  }
}