
{
  "ground": {
    "symbols": {
      "=" : {"class": "avividi.com.controller.gameitems.staticitems.Ground"},
      "#" : {
        "class": "avividi.com.controller.gameitems.staticitems.CustomStaticItem",
        "images": ["cliff1/cliff1-full"],
        "transform": "none"
      },
      "Ø" : {
        "class": "avividi.com.controller.gameitems.staticitems.AutoEdge",
        "innerClass": "avividi.com.controller.gameitems.staticitems.CustomStaticItem",
        "background": "grounddirt",
        "location": "cliff1"
      }
    },
    "map": [
      "= = = = = = = = = = Ø # # # # Ø = = = = = = = = = = =",
      " = = = = = = = = = = Ø # # # # Ø Ø = = = = = = = = = ",
      "= = = = = = = = = = Ø # # # # # # Ø = = = = = = = = =",
      " = = = = = = = = = Ø # Ø Ø # Ø Ø # Ø = = = = = = = = ",
      "= = = = = = = = = = Ø Ø = Ø Ø = Ø # Ø Ø = = = = = = =",
      " Ø = = = = = = = = = = = = = = = Ø # # Ø = = = = = = ",
      "# Ø Ø = = = = = = = = = = = = = = Ø Ø Ø = = = = = = =",
      " # # Ø = = Ø Ø = = = = = = = = = = = = = = = Ø Ø = = ",
      "Ø Ø # Ø = Ø # Ø = = = = = = = = = = = Ø Ø Ø Ø # Ø = =",
      " = Ø # Ø Ø # Ø = = = = = = = = = = = Ø # # # # # Ø = ",
      "= Ø # # # # Ø = = = = = = = = = = = Ø # # # # # Ø = =",
      " = Ø # Ø Ø Ø = = = = = = = = = = = = Ø Ø # # Ø Ø = = ",
      "= = Ø Ø = = = = = = = = = = = = = = = = Ø Ø Ø = = = =",
      " = = = = = = = = = = = = = = = = = = = = = = = = = = ",
      "= = = = = Ø Ø = = = = = = = = = = = = = = = = = = = =",
      " = = = = Ø # Ø = = = = = = = = = = = = = = = = = = = ",
      "= = = = = Ø # Ø = = = = = = = = = = = = = = = = = = =",
      " = = = = = Ø Ø = = = = = Ø Ø = = = = = = = = = = = = ",
      "= = = = = = = = = = = Ø Ø # Ø = = = = Ø Ø = = = = = =",
      " = = = = = = = = = = Ø # # Ø = = = = Ø # Ø = = = = = ",
      "= = = = = = = = = = = Ø # # Ø Ø Ø Ø Ø # Ø = = = = = =",
      " = = = = = = = = = = = Ø # # # # # # # # Ø = = = = = "
    ]
  },
  "other": {
    "symbols": {
      "W" : {"class": "avividi.com.controller.gameitems.other.Fire"},
      "§" : {"class": "avividi.com.controller.gameitems.other.FirePlant"},
      "O" : {"class": "avividi.com.controller.gameitems.other.Boulder"},
      "#" : {"class": "avividi.com.controller.gameitems.other.Brick"}
    },
    "map": [
      "§ § § + + + + + + + + + + § + + + + + + + + + + + + +",
      " § + + + + + + + + + + + § § + + + + + + + + + + + + ",
      "§ § § + + + + + + + + + + + + + + + + + + + + + § + +",
      " + § + + + + + + + + + + + + + + + + + + + + + § § + ",
      "§ § + § + § + + # # + + + + + + + + + + + + + + + + +",
      " + + + + + + + + + + + + + + + + + + + + + + + + + + ",
      "+ + + + + + § + + + + + + + + + + + + + + + + + § + +",
      " § + + + + + + + + + + + + + + + + + + + + + + + + + ",
      "+ + + + + + + + + + + + + + + + + + + + + + + + + § +",
      " + + + + + + + + + + + + + + + + + + + + + + + + + § ",
      "+ + O + + + + + + + + + + W + + + + + + + + + + + + +",
      " + + + + + + + + + + + + + + + + + + + + + + + + + + ",
      "+ + + + + + + + + + + + + + + + + + + + + + + + + + +",
      " + + + + + + + + + + + + + + + + + + + + + + + + + + ",
      "+ + + + + + + + + + + + + + + + + + + + + + + + + + +",
      " + O + + + + + + + + + + + + + + + + + + + + + + § § ",
      "+ + + + + + + + + + + + + + + + + + + + + + § + § + §",
      " + + + + + + + § + + + + + + + + + + + + + + + § § § ",
      "+ + + + + + § § § + + + + + + + + + + + + + + § § § §",
      " + + + + + + § + § + + + + + + + + + + + + + + + + § ",
      "+ + + + + + + + + + + + + + + + + + + + + + + + § § +",
      " + + § § + + + + + + § + + + + § + + + + + + + + + + "
    ]
  },
  "units": {
    "symbols": {
      "S" : {"class": "avividi.com.controller.gameitems.unit.Maldar"},
      "U" : {"class": "avividi.com.controller.gameitems.unit.Rivskin"}
    },
    "map": [
      "+ + + + + + + + + + + + + + + + + + + + + + + + + S +",
      " + + + + + + + + + + + + + + + + + + + + + + + + + + ",
      "+ + + + + + + + + + + + + + + + + + + + + + + + + + +",
      " + + + + + + + + + + + + + + + + + + + + + + + + + + ",
      "+ + + + + + + + + + + + + + + + + + + + + + + + + + +",
      " + + + + + + + + + + + + + + + + + + + + + + + + + + ",
      "+ + + + + + + + S S + + + + + + + + + + + + + + + + +",
      " + + + + + + + S S S S S + + + + + + + + + + + + + + ",
      "+ + + + + + + + S S S S + + + + + + + + + + + + + + +",
      " + + + + + + + + S S S + + + + + + + + + + + + + + + ",
      "+ + + + + + + + + + + + + + + + + + + + + + + + + + +",
      " + + + + + + + + + + + + + + + + + + + + + + + + + + ",
      "+ + + + + + + + + + + + + + + + + + + + + + + + + + +",
      " + + + + + + + + + + + + + + + + + + + + + + + + + + ",
      "+ + + + + + + + + + + + + + + + + + + + + + + + + + +",
      " + + + + + + + + + + + + + + + + + + + + + + + + + + ",
      "+ + + + + + + + + + + + + + + + + + + + + + + + + + +",
      " + + + + + + + + + + + + + + + + + + + + + + + + + + ",
      "+ + + + + + + + + + + + + + + + + + + + + + + + + + +",
      " + + + + + + + + + + + + + + + + + + + + + + + + + + ",
      "+ + U + + + + + + + + + + + + + + + + + + + + + + + +",
      " + + + + + + + + + + + + + + + + + + + + + + + + + S "
    ]
  }
}