
{
  "ground": {
    "symbols": {
      "=" : {"class": "avividi.com.controller.gameitems.staticitems.Ground"},
      "#" : {"images": ["cliff-full"], "transform": "none"},
      "1" : {"images": ["grounddirt", "cliff-ne"], "transform": "flipped"},
      "2" : {"images": ["grounddirt", "cliff-corner"], "transform": "flipped"},
      "3" : {"images": ["grounddirt", "cliff-up"], "transform": "none"},
      "4" : {"images": ["grounddirt", "cliff-corner"], "transform": "none"},
      "5" : {"images": ["grounddirt", "cliff-ne"], "transform": "none"}
    },
    "map": [
      "= = = = = = = = 1 # # # # # # # 5 = = = = = = = = = =",
      " = = = = = = = = 1 # # # # # # 5 = = = = = = = = = = ",
      "= = = = = = = = = 1 # # # # # 5 = = = = = = = = = = =",
      " = = = = = = = = = 1 # # # # 5 = = = = = = = = = = = ",
      "= = = = = = = = = = 2 3 3 3 4 = = = = = = = = = = = =",
      " = = = = = = = = = = = = = = = = = = = = = = = = = = ",
      "= = = = = = = = = = = = = = = = = = = = = = = = = = =",
      " = = = = = = = = = = = = = = = = = = = = = = = = = = ",
      "= = = = = = = = = = = = = = = = = = = = = = = = = = =",
      " = = = = = = = = = = = = = = = = = = = = = = = = = = ",
      "= = = = = = = = = = = = = = = = = = = = = = = = = = =",
      " = = = = = = = = = = = = = = = = = = = = = = = = = = ",
      "= = = = = = = = = = = = = = = = = = = = = = = = = = =",
      " = = = = = = = = = = = = = = = = = = = = = = = = = = ",
      "= = = = = = = = = = = = = = = = = = = = = = = = = = =",
      " = = = = = = = = = = = = = = = = = = = = = = = = = = ",
      "= = = = = = = = = = = = = = = = = = = = = = = = = = =",
      " = = = = = = = = = = = = = = = = = = = = = = = = = = ",
      "= = = = = = = = = = = = = = = = = = = = = = = = = = =",
      " = = = = = = = = = = = = = = = = = = = = = = = = = = ",
      "= = = = = = = = = = = = = = = = = = = = = = = = = = =",
      " = = = = = = = = = = = = = = = = = = = = = = = = = = "
    ]
  },
  "other": {
    "symbols": {
      "W" : {"class": "avividi.com.controller.gameitems.other.Fire"},
      "§" : {"class": "avividi.com.controller.gameitems.other.FirePlant"},
      "O" : {"class": "avividi.com.controller.gameitems.other.Boulder"},
      "#" : {"class": "avividi.com.controller.gameitems.other.Brick"}
    },
    "map": [
      "§ § § + + + + + + + + + + + § + + + + + + + + + + + +",
      " § + + + + + + + + + + + + § § + + + + + + + + + + + ",
      "§ § § + + + + + + + + + + + + + + + + + + + + + § + +",
      " + § + + + + + + + + + + + + + + + + + + + + + § § + ",
      "§ § + § + § + + # # + + + + + + + + + + + + + + + + +",
      " § + + + + + + + + + + + + + + + + + + + + + + + + + ",
      "§ + + + + + § + + + + + + + + + + + + + + + + + § + +",
      " § + + + + + + + + + + + + + + + + + + + + + + + + + ",
      "+ + + + + + + + + + + + + + + + + + + + + + + + + § +",
      " + + O + + + + + + + + + + + + + + + + + + + + + + § ",
      "+ + O + + + + + + + + + + W + + + + + + + + + + + + +",
      " + + + + + + + + + + + + + + + + + + + + + + + + + + ",
      "+ + + + + + + + + + + + + + + + + + + + + + + + + + +",
      " + + + + O + + + + + + + + + + + + + + + + + + + + + ",
      "+ + + + + + + + + + + + + + + + + + + + + + + + + + +",
      " + + + + + + + + + + + + + + + + + + + + + + + + § § ",
      "+ + + + + + + + + + + + + + + + + + + + + + § + § + §",
      " + + + + + + § § + + + + + + + + + + + + + + + § § § ",
      "+ + + + + + § § § + + + + + + + + + + + + + + § § § §",
      " + + + + + + § + § + + + + + + + + + + + + + + + + § ",
      "+ + + + + + + + + + + + + + + + + + + + + + + + § § +",
      " + + § § + + + + + + + § + + + § + + + + + + + + + + "
    ]
  },
  "units": {
    "symbols": {
      "S" : {"class": "avividi.com.controller.gameitems.unit.Maldar"},
      "U" : {"class": "avividi.com.controller.gameitems.unit.Rivskin"}
    },
    "map": [
      "+ + + + + + + + + + + + + + + + + + + + + + + + + S +",
      " + + + + + + + + + + + + + + + + + + + + + + + + + + ",
      "+ + + + + + + + + + + + + + + + + + + + + + + + + + +",
      " + + + + + + + + + + + + + + + + + + + + + + + + + + ",
      "+ + + + + + + + + + + + + + + + + + + + + + + + + + +",
      " + + + + + + + + + + + + + + + + + + + + + + + + + + ",
      "+ + + + + + + + S S + + + + + + + + + + + + + + + + +",
      " + + + + + + + S S S S S + + + + + + + + + + + + + + ",
      "+ + + + + + + + S S S S + + + + + + + + + + + + + + +",
      " + + + + + + + + S S S + + + + + + + + + + + + + + + ",
      "+ + + + + + + + + + + + + + + + + + + + + + + + + + +",
      " + + + + + + + + + + + + + + + + + + + + + + + + + + ",
      "+ + + + + + + + + + + + + + + + + + + + + + + + + + +",
      " + + + + + + + + + + + + + + + + + + + + + + + + + + ",
      "+ + + + + + + + + + + + + + + + + + + + + + + + + + +",
      " + + + + + + + + + + + + + + + + + + + + + + + + + + ",
      "+ + + + + + + + + + + + + + + + + + + + + + + + + + +",
      " + + + + + + + + + + + + + + + + + + + + + + + + + + ",
      "+ + + + + + + + + + + + + + + + + + + + + + + + + + +",
      " + + + + + + + + + + + + + + + + + + + + + + + + + + ",
      "+ + U + + + + + + + + + + + + + + + + + + + + + + + +",
      " + + + + + + + + + + + + + + + + + + + + + + + + + S "
    ]
  }
}