{
  "ground": {
    "symbols": {
      "=": {
        "class": "${default}.gamehex.staticitems.CustomStaticItem",
        "images": [
          "reddirt"
        ],
        "transform": "none",
        "passable": true
      },
      "#": {
        "class": "${default}.gamehex.staticitems.CustomStaticItem",
        "images": [
          "reddirt"
        ],
        "transform": "none",
        "passable": true,
        "id": "clifftop"
      },
      //      "#": {
      //        "class": "${default}.gamehex.staticitems.CustomStaticItem",
      //        "images": [
      //          "cliff-background-1/cliff-background-1-full"
      //        ],
      //        "id": "clifftop",
      //        "transform": "none",
      //        "passable": false
      //      },
      "Ø": {
        "class": "${default}.gamehex.staticitems.AutoEdge",
        "innerTypeId": "clifftop",
        "background": "reddirt",
        //        "innerBackgroundLocation": "cliff-background-1",
        "location": "cliff2"
      }
    },
    "map": [
      "= = = = = = = = = = = = = = = = = = = = = = = = = = = = = = =",
      " = = = = = = = = = = = = = = = = = = = = = = = = = = = = = = ",
      "= = Ø Ø = = = = = = = = = = = = = = = = = = = = = = = = = = =",
      " = Ø # Ø = = = = = = = = = = = = = = = = = = = = = = = = = = ",
      "= = Ø Ø = = = = = = = = = = = = = = = = = = = = = = = = = = =",
      " = = = = = = = = = = = = = = = = = = = = = = = = = = = = = = ",
      "= = = = = = = = = = = = = = = = = = = = = = = = = = = = = = =",
      " = = = = = = = = = = = = = = = = = = = = = = = = = = = = = = ",
      "= = = = = = = = = = = = = = = = = = = = = = = = = = = = = = =",
      " = = = = = = = = = = = = = = = = = = = = = = = = = = = = = = ",
      "= = = = = = = = = = = = = = = = = = = = = = = = = = = = = = =",
      " = = = = = = = = = = = = = = = = = = = = = = = = = = = = = = ",
      "= = = = = = = = = = = = = = = = = = = = = = = = = = = = = = =",
      " = = = = = = = = = = = = = = = = = = = = = = = = = = = = = = ",
      "= = = = = = = = = = = = = = = = = = = = = = = = = = = = = = =",
      " = = = = = = = = = = = = = = = = = = = = = = = = = = = = = = ",
      "= = = = = = = = = = = = = = = = = = = = = = = = = = = = = = =",
      " = = = = = = = = = = = = = = = = = = = = = = = = = = = = = = ",
      "= = = = = = = = = = = = = = = = = = = = = = = = = = = = = = =",
      " = = = = = = = = = = = = = = = = = = = = = = = = = = = = = = ",
      "= = = = = = = = = = = = = = = = = = = = = = = = = = = = = = =",
      " = = = = = = = = = = = = = = = = = = = = = = = = = = = = = = ",
      "= = = = = = = = = = = = = = = = = = = = = = = = = = = = = = =",
      " = = = = = = = = = = = = = = = = = = = = = = = = = = = = = = ",
      "= = = = = = = = = = = = = = = = = = = = = = = = = = = = = = ="
    ]
  },
  "other": {
    "symbols": {
      "w": {
        "class": "${default}.gamehex.other.Fire"
      },
      "§": {
        "class": "${default}.gamehex.other.LiveFirePlant", "lifeStage": 160
      },
      "/": {
        "class": "${default}.gamehex.other.DeadFirePlant"
      },
      "#": {
        "class": "${default}.gamehex.other.Brick"
      },
      "O": {
        "class": "${default}.gamehex.other.DroppedItemInteractor",
        "imageName": "boulder/boulder",
        "passable": true,
        "itemType": "avividi.com.monuments.controller.item.BoulderItem"
      }
    },
    "map": [
      "+ + + + + + + + + + + + + + + + + + + + + + + + + + + + + + +",
      " + + + + + + + + + + + + + + + + + + + + + + + + + + + + + + ",
      "+ + + + + + + + + + + + + + + + + + + + + + + + + + + + + + +",
      " + + + + + + + + + + + + + + + + + + + + + + + + + + + + + + ",
      "+ + + + + + + + + + + + + + + + + + + + + + + + + + + + + + +",
      " + + + + + + + + + + + + + + + + + + + + + + + + + + + + + + ",
      "+ + + + + + + + + + + + + + + + + + + + + + + + + + + + + + +",
      " + + + + + + + + + + + + + + + + + + + + + + + + + + + + + + ",
      "+ + + + + + + + + + + + + + + + + + + + + + + + + + + + + + +",
      " + + + + + + + + + + + + + + + + + + + + + + + + + + + + + + ",
      "+ + + + + + + + + + + + + + + + + + + + + + + + + + + + + + +",
      " + + + + + + + + + + + + + + + + + + + + + + + + + + + + + + ",
      "+ + + + + + § § § + + + + + + + + + + + + + + + + + + + + + +",
      " + + + + + + + + + + + + + + + + + + + + + + + + + + + + + + ",
      "+ + + + + + + + + + + + + + + + + + + + + + + + + + + + + + +",
      " + + + + + + + + + + + + + + + + + + + + + + + + + + + + + + ",
      "+ + + + + + + + + + + + + + + + + + + + + + + + + + + + + + +",
      " + + + + + + + + + + + + + + + + + + + + + + + + + + + + + + ",
      "+ + + + + + + + + + + + + + + + + + + + + + + + + + + + + + +",
      " + + + + + + + + + + + + + + + + + + + + + + + + + + + + + + ",
      "+ + + + + + + + + + + + + + + + + + + + + + + + + + + + + + +",
      " + + + + + + + + + + + + + + + + + + + + + + + + + + + + + + ",
      "+ + + + + + + + + + + + + + + + + + + + + + + + + + + + + + +",
      " + + + + + + + + + + + + + + + + + + + + + + + + + + + + + + ",
      "+ + + + + + + + + + + + + + + + + + + + + + + + + + + + + + +"
    ]
  },
  "units": {
    "symbols": {
      "S": {
        "class": "${default}.gamehex.unit.Maldar"
      }
    },
    "map": [
      "+ + + + + + + + + + + + + + + + + + + + + + + + + + + + + + +",
      " + + + + + + + + + + + + + + + + + + + + + + + + + + + + + + ",
      "+ + + + + + + + + + + + + + + + + + + + + + + + + + + + + + +",
      " + + + + + + + + + + + + + S + + + + + + + + + + + + + + + + ",
      "+ + + + + + + + + + + + + S + + + + + + + + + + + + + + + + +",
      " + + + + + + + + + + + + + S + + + + + + + + + + + + + + + + ",
      "+ + + + + + + + + + + + + + + + + + + + + + + + + + + + + + +",
      " + + + + + + + + + + + + + + + + + + + + + + + + + + + + + + ",
      "+ + + + + + + + + + + + + + + + + + + + + + + + + + + + + + +",
      " + + + + + + + + + + + + + + + + + + + + + + + + + + + + + + ",
      "+ + + + + + + + + + + + + + + + + + + + + + + + + + + + + + +",
      " + + + + + + + + + + + + + + + + + + + + + + + + + + + + + + ",
      "+ + + + + + + + + + + + + + + + + + + + + + + + + + + + + + +",
      " + + + + + + + + + + + + + + + + + + + + + + + + + + + + + + ",
      "+ + + + + + + + + + + + + + + + + + + + + + + + + + + + + + +",
      " + + + + + + + + + + + + + + + + + + + + + + + + + + + + + + ",
      "+ + + + + + + + + + + + + + + + + + + + + + + + + + + + + + +",
      " + + + + + + + + + + + + + + + + + + + + + + + + + + + + + + ",
      "+ + + + + + + + + + + + + + + + + + + + + + + + + + + + + + +",
      " + + + + + + + + + + + + + + + + + + + + + + + + + + + + + + ",
      "+ + + + + + + + + + + + + + + + + + + + + + + + + + + + + + +",
      " + + + + + + + + + + + + + + + + + + + + + + + + + + + + + + ",
      "+ + + + + + + + + + + + + + + + + + + + + + + + + + + + + + +",
      " + + + + + + + + + + + + + + + + + + + + + + + + + + + + + + ",
      "+ + + + + + + + + + + + + + + + + + + + + + + + + + + + + + +"
    ]
  }
}
