
{
  "ground": {
    "symbols": {
      "=" : {
        "class": "avividi.com.controller.gameitems.staticitems.CustomStaticItem",
        "images": ["reddirt"],
        "transform": "none",
        "passable": true
      },
      "#" : {
        "class": "avividi.com.controller.gameitems.staticitems.CustomStaticItem",
        "images": ["cliff1/cliff1-full"],
        "transform": "none",
        "passable": false
      },
      "Ø" : {
        "class": "avividi.com.controller.gameitems.staticitems.AutoEdge",
        "innerEdgeFirstImage": "cliff1/cliff1-full",
        "background": "reddirt",
        "location": "cliff1"
      }
    },
    "map": [
      "= = = = = = = = = = = = = = = = = = = = = = = = = = = = = = = = = = = = = = = = = = = = = = = = = = = = = =",
      " = = = = = = = = = = = = = = = = Ø Ø = = = = = = = = = = = = = = = = = = = = = = = = = = = = = = = = = = = ",
      "= = = = = = = = = = = = = Ø Ø = Ø # Ø = = = = = = = = = = = = = = = = = = = = = = = = = = = = = = = = = = =",
      " = = = = = = = = = = = Ø Ø # Ø Ø # # Ø Ø = = = = = = = = = = = = = = = = = = = = = = = = = = = = = = = = = ",
      "= = = = = = = = = Ø Ø Ø # # # # # # # # Ø Ø = = = = = = = = = = = = = = = = = = = = = = = = = = = = = = = =",
      " = = = = = = = Ø Ø # # # Ø Ø # # Ø Ø Ø # # Ø = = = = = = = = = = = = = = = = = = = = = = = = = = = = = = = ",
      "= = = = = Ø Ø Ø # # Ø Ø Ø = Ø Ø Ø = = Ø # # Ø = = = = = = = = = = = = = = = = = = = = = = = = = = = = = = =",
      " = = = = Ø # # # Ø Ø = = = = = = = = = Ø # Ø = = = = = = = = = = = = = = = = = = = = = = = = = = = = = = = ",
      "= = = = Ø # # # Ø = = = = = = = = = = Ø # Ø = = = = = = = = = = = = = = = = = = = = = = = = = = = = = = = =",
      " = = = = Ø # Ø Ø = = = = = = = = = = = Ø # Ø = = = = = = = = = = = = = = = = = = = = = = = = = = = = = = = ",
      "= = = = Ø # Ø = = = = = = = = = = = = = Ø # Ø = = = = = = = = = = = = = = = = = = = = = = = = = = = = = = =",
      " = = = = Ø # Ø = = = = = = = = = = = = Ø # # Ø = = = = = = = = = = = = = = = = = = = = = = = = = = = = = = ",
      "= = = = = Ø # Ø Ø = = = = = = = = = = = Ø # # Ø = = = = = = = = = = = = = = = = = = Ø Ø Ø = = = = = = = = =",
      " = = = = Ø # # # Ø Ø Ø = = = = = = = Ø Ø # # # Ø = = = = = = = = = = = = = = = = = Ø # # Ø = = = = = = = = ",
      "= = = = = Ø Ø # # # # Ø = = = = = = Ø # # # Ø Ø = = = = = = = = = = = = = = = = = Ø # # # Ø = = = = = = = =",
      " = = = = = = Ø # Ø Ø # Ø = = = Ø Ø Ø # # Ø Ø = = = = = = = = = = = = = = = = = = Ø # # Ø Ø = = = = = = = = ",
      "= = = = = = = Ø Ø = Ø # Ø = = Ø # # # Ø Ø = = = = = = = = = = = = = = = = = = = = Ø # Ø = = = = = = = = = =",
      " = = = = = = = = = = Ø Ø = = = Ø Ø Ø Ø = = = = = = = = = = = = = = = = = = = = = Ø # Ø = = = = = = = = = = ",
      "= = = = = = = = = = = = = = = = = = = = = = = = = = = = = = = = = = = = = = = = Ø # Ø = = = = = = = = = = =",
      " = = = = = = = = = = = = = = = = = = = = = = = = = = = = = = = = = = = = = = = Ø # # Ø = = = = = = = = = = ",
      "= = = = = = = = = = = = = = = = = = = = = = = = = = = = = = = = = = = = = = = = Ø # # Ø = = = = = = = = = =",
      " = = = = = = = = = = = = = = = = = = = = = = = = = = = = = = = = = = = = = = Ø Ø # # Ø = = = = = = = = = = ",
      "= = = = = = = = = = = = = = = = = = = = = = = = = = = = = = = = = = = = = = Ø # # # Ø = = = = = = = = = = =",
      " = = = = = = = = = = = = = = = = = = = = = = = = = = = = = = = = = = = = = Ø # # Ø Ø = = = = = = = = = = = ",
      "= = = = = = = = = = = = = = = = = = = = = = = = = = = = = = = = = = = = = = Ø Ø Ø = = = = = = = = = = = = =",
      " = = = = = = = = = = = = = = = = = = = = = = = = = = = = = = = = = = = = = = = = = = = = = = = = = = = = = ",
      "= = = = = = = = = = = = = = = = = = = = = = = = = = = = = = = = = = = = = = = = = = = = = = = = = = = = = =",
      " = = = = = = = = = = = = = = = = = = = = = = = = = = = = = = = = = = = = = = = = = = = = = = = = = = = = = ",
      "= = = = = = = = = = = = = = = = = = = = = = = = = = = = = = = = = = = = = = = = = = = = = = = = = = = = = =",
      " = = = = = = = = = = = = = = = = = = = = = = = = = = = = = = = = = = = = = = = = = = = = = = = = = = = = = ",
      "= = = = = = = = = = = = = = = = Ø Ø Ø Ø = = = = = = = = = = = = = = = = = = = = = = = = = = = = = = = = = =",
      " = = = = = = = = = = = = = = Ø Ø # # # Ø = = = = = = = = = = = = = = = = = = = = = = = = = = = = = = = = = ",
      "= = = = = = = = = = = = = = Ø # # # # # Ø = = = = = = = = = = = = = = = = = = = = = = = = = = = = = = = = =",
      " = = = = = = = = = = = = = = Ø # Ø Ø # # Ø = = = = = = = = = = = = = = = = = = = = = = = = = = = = = = = = ",
      "= = = = = = = = = = Ø Ø = = Ø # Ø = Ø # Ø = = = = = = = = = = = = = = = = = = = = = = = = = = = = = = = = =",
      " = = = = = = = = = Ø # Ø Ø Ø # Ø = = Ø Ø = = = = = = = = = = = = = = = = = = = = = = = = = = = = = = = = = ",
      "= = = = = = = = = Ø # # # # # Ø = = = = = = = = = = = = = = = = = = = = = = = = = = = = = = = = = = = = = =",
      " = = = = = = = = = Ø Ø Ø # # # Ø = = = = = = = = = = = = = = = = = = = = = = = = = = = = = = = = = = = = = ",
      "= = = = = = = = = = = = Ø # # # Ø = = = = = = = = = = = = = = = = = = = = = = = = = = = = = = = = = = = = =",
      " = = = = = = = = = = = Ø # # # # Ø Ø = = = = = = = = = = = = = = = = = = = = = = = = = = = = = = = = = = = ",
      "= = = = = = = = = = = Ø # # # # # # Ø = = = = = = = = = = = = = = = = = = = = = = = = = = = = = = = = = = =",
      " = = = = = = = = = = = Ø # Ø Ø # # Ø = = = = = = = = = = = = = = = = = = = = = = = = = = = Ø Ø Ø Ø = = = = ",
      "= = = = = = = = = = = = Ø Ø = Ø # Ø = = = = = = = = = = = = = = = = = = = = = = = = = = = Ø # # # Ø = = = =",
      " = = = = = = = = = = = = = = = Ø Ø = = = = = = = = = = = = = = = = = = = = = = = = = = = Ø # # Ø Ø = = = = ",
      "= = = = = = = = = = = = = = = = = = = = = = = = = = = = = = = = = = = = = = = = = = = = = Ø # Ø = = = = = =",
      " = = = = = = = = = = = = = = = = = = = = = = = = = = = = = = = = = = = = = = = = = = = = = Ø Ø = = = = = = "
    ]
  },
  "other": {
    "symbols": {
      "W" : {"class": "avividi.com.controller.gameitems.other.Fire"},
      "§" : {"class": "avividi.com.controller.gameitems.other.FirePlant"},
      "O" : {"class": "avividi.com.controller.gameitems.other.Boulder"},
      "#" : {"class": "avividi.com.controller.gameitems.other.Brick"},
      "%" : {
        "class": "avividi.com.controller.item.DroppedItemInteractor",
        "imageName": "driedPlantItem/driedPlantItem",
        "passable": true,
        "itemType": "avividi.com.controller.item.DriedPlantItem"

      }
    },
    "map": [
      "+ + + + + + + + + + + + + + + + + + + + + + + + + + + + + + + + + + + + + + + + + + + + + + + + + + + § § +",
      " § + § + + + + § + + + + + + + + + + + + + + + + + + + + + + + + + + + + + + + + + + + + + + + + + + § § § ",
      "+ § § § + + + + + + + + + + + + + + + + + + § + § + + + + + + + + + + + + + + + + + + + + + + + + + + + + +",
      " § § + + + + + + + + + + + + + + + + + + + + § + + + + + + + + + + + + + + + + + + + + + + + + + + + + + + ",
      "+ + + + + + + + + + + + + + + + + + + § + + + + + + + + + + + + + + + + + + + + + + + + + + + + + + + + + +",
      " + + + + + + + + + § + + + + + + + + + + + + + + + + + + + + + + + + + + + + + + + + + + + + + + + + + + + ",
      "+ + + + + + + + + + + + + § + + + + § + + + + + + + + + + + + + + + + + + + + + + + + + + + + + + + + + + +",
      " + + § + + + + + + + + + + § + + + § § + + + + + + + + + + + + + + + + + + + + + + + + + + + + + + + + + + ",
      "+ + + + + + + + + + + § + + + + + + + + + + + + § § + + + + + + + + + + + + + + + + + + + + + + + + + + + +",
      " + + + + + + + + § + + + + + + + + + + + + + + + + § + + + + + + + + + + + + + + + + + + + + + + + + + + + ",
      "§ § + + + § + § § + + + + + + + + + + + + + + + + § + + + + + + + + + + + + + + + + + + + + + + + + + + + +",
      " § + + + + + + + + + + + + + + + § + + + § + + + + + + + + + + + + + + + + + + + + § § + + + + + + + + + + ",
      "+ + + + + + + + + § § + + § + + § § + + + § + + + + + + + + + + + + + + + + + + + + + + + + + + + + + + + +",
      " + + + + + + + + + + + + + + + + + + + + + + + + + + + + + + + + + + + + + + + + + + + + + + + + + + + + + ",
      "+ + + + + + + + § + + + + + + + + § + + + + + + + + + + + + + + + + + + + + + + + + + + + + + + + + + + + +",
      " + + + + § + + + + + + + § + + + + + + + + + + + + + + + + + + + + + + + + + + § + + + + + + + + + + + + + ",
      "+ + + + + + + + + + + + + + + + + + + + + + § + + + + + + + + + + + + + + + + + + + + + + + + + + + + + + +",
      " + + + + + + + + + + + + + + + + + + + + + + + + + + + + + + + + + + + + + + + + + + + + + + + + + + + + + ",
      "+ + + + + + + + + + + + + + + + + + + + + + + + + + + + + + + + + + + + + + + + + + + + § + + + + + + + + +",
      " § + + + + + + + + + + + + + + + + + + § + + + + + + + + + + + + + + + + + + + + + + + § § + + + + + + + + ",
      "§ § + + + + + + § + + + + + + + + + + + § + + + + + + + + + + + + + + + + + + + + + + + § + + + + + + + + §",
      " § + § + + + + + + + + + + + + + + + + § + % + + + + + + + + + + + + + + + + + + + + + + + + + + + + + + + ",
      "+ + + + + + + + + + + + + + + + + + + + + + + + + + + + + + + + + + + + + + + + + + + + + + + + + + + + + +",
      " + + + + + + + + + + + + + + + + + + + + + + + + + + + + + + + + + + + + + + + + + + + + + + + + + + + + + ",
      "+ + + + + + + + + + + + + + + + + + + + + + + + + + + § + + + + + + + + + + + + + + + + + + + + + + + + + +",
      " + + + + + + + + + + + + + + + + + + + + + + + + + § § + + + + + + + + + + + + + + + + + + + + + + + + + + ",
      "+ + + + + + + + + + + + + + + + + + + + + + + + + + + + + + + + + + + + + + + + + + + + + + + + + + + + + +",
      " + + + + + + + + + + + + + + + + + + + + + + + + + + + + + + + + + + + + + + + + + + + + + + + + + + + + + ",
      "+ + + + + + § + + + + + + + + + + + + + + + + + + + + + + § + + + + + + + + + + + + + + + + + + + + + + + +",
      " + + + + + § + + + + + + + + + + + + + + + + + + + + + + + + + + + + + + + + + + + + + + + + + + + + + + + ",
      "+ + + + + + + + + + + + + + + + + + + + § + + + + + + + + + + + + + + + + + + + + + + + + + + + + + + + + +",
      " + + + + + + + + + + + + + + + + + + + + + + + + + + + + + + + + + + + + + + § § + + + + + + + + + + + + + ",
      "+ + + + + + + + + + + + + + + + + + + + + + + + + + + + + + + + + + + + + + § + + + + + + + + + + + + + + +",
      " + + + + + § + + + + + + + + + + + + + + + + + + + + + + + + + + + + + + + + + + + + + + + + + + + + + + + ",
      "+ + + + + + § + + + + + + + + + + + + + + + + + + + + + W + + + + + + + + + + + + + + + + + + + + + + + + +",
      " + + + + + + + + + + + + + + + + + + + + + + + + + + + + + + + + + + + + + + + + + + + + + + + + + + + + + ",
      "+ + + + + + + + + + + + + + + + + + + + + + + + + + + + + + + + + + + + + + + + + + + + + + + + + + + + + +",
      " + + + + + + + + + + + + + + + + § § + + + + + + + + + + + + + + + + + + + + + + + + + + + + + + + + + + + ",
      "+ + + + + + + + + + + + + + + + + § + + + + + + + + + + + + + + + + + + + + + + + + + + + + + + + + + + + +",
      " + + + + + + + + + + + + + + + + + + + + + + + + + + + + + + + + + + + + + + + + + + + + + + + + + + + + + ",
      "+ + + + + + + + + + + + + + + + + + + + + + + + + + + + + + + + + + + + + + + + + + + + + + + + + + + + + +",
      " + + + + + + + + + + + + + + + + + + + + + + + + + + + + + + + + + + + + + + + + + + + + + + + + + + + + + ",
      "+ + + + + + + + + + + + + + + + + + + + + + + + + + + + + + + + + + + + + + + + + + + + + + + + + + + + + +",
      " + + + + + + + + + § + + + + + + + + + + + + + + + + + + + + + + + + + + + + + + + + + + + + + + + + + + + ",
      "+ + + + § + + + + + + + + + + + + + + + + + + + + + + + + + + + + + + + + + + + + + + + + + + + + + + + + §",
      " + + + § § + + + + + + + + + + + + + + + + + + + + + + + + + + + + + + + § + + + + + + + + + + + + + + + § "
    ]
  },
  "units": {
    "symbols": {
      "S" : {"class": "avividi.com.controller.gameitems.unit.Maldar"},
      "U" : {"class": "avividi.com.controller.gameitems.unit.Rivskin"}
    },
    "map": [
      "+ + + + + + + + + + + + + S S S S S S S S S S S S S S S S S S S S S S S S S S S S S S S S S S + + + + + + +",
      " + + + + + + + + + + + + + + + + + + + + + + + + + + + + + + + + + + + + + + + + + + + + + + + + + + + + + ",
      "+ + + + + + + + + + + + + + + + + + + + + + + + + + + + + + + + + + + + + + + + + + + + + + + + + + + + + +",
      " + + + + + + + + + + + + + + + + + + + + + + + + + + + + + + + + + + + + + + + + + + + + + + + + + + + + + ",
      "+ + + + + + + + + + + + + + + + + + + + + + + + + + + + + + + + + + + + + + + + + + + + + + + + + + + + + +",
      " + + + + + + + + + + + + + + + + + + + + + + + + + + + + + + + + + + + + + + + + + + + + + + + + + + + + + ",
      "+ + + + + + + + + + + + + + + + + + + + + + + + + + + + + + + + + + + + + + + + + + + + + + + + + + + + + +",
      " + + + + + + + + + + + + + + + + + + + + + + + + + + + + + + + + + + + + + + + + + + + + + + + + + + + + + ",
      "+ + + + + + + + + + + + + + + + + + + + + + + + + + + + + + + + + + + + + + + + + + + + + + + + + + + + + +",
      " + + + + + + + + + + + + S + + + + + + + + + + + + + + + + + + + + + + + + + + + + + + + + + + + + + + + + ",
      "+ + + + + + + + + + + + + + + + + + + + + + + + + + + + + + + + + + + + + + + + + + + + + + + + + + + + + +",
      " + + + + + + + + + + + + + + + + + + + + + + + + + + + + + + + + + + + + + + + + + + + + + + + + + + + + + ",
      "+ + + + + + + + + + + + + + + + + + + + + + + + + + + + + + + + + + + + + + + + + + + + + + + + + + + + + +",
      " + + + + + + + + + + + + + + + + + + + + + + + + + + + + + + + + + + + + + + + + + + + + + + + + + + + + + ",
      "+ + + + + + + + + + + + + + + + + + + + + + + + + + + + + + + + + + + + + + + + + + + + + + + + + + + + + +",
      " + + + + + + + + + + + + + + + + + + + + + + + + + + + + + + + + + + + + + + + + + + + + + + + + + + + + + ",
      "+ + + + + + + + + + + + + + + + + + + + + + + + + + + + + + + + + + + + + + + + + + + + + + + + + + + + + +",
      " + + + + + + + + + + + + + + + + + + + + + + + + + + + + + + + + + + + + + + + + + + + + + + + + + + + + + ",
      "+ + + + + + + + + + + + + + + + + + + + + + + + + + + + + + + + + + + + + + + + + + + + + + + + + + + + + +",
      " + + + + + + + + + + + + + + + + + + + + + + + + + + + + + + + + + + + + + + + + + + + + + + + + + + + + + ",
      "+ + + + + + + + + + + + + + + + + + + + + + + + + + + + + + + + + + + + + + + + + + + + + + + + + + + + + +",
      " + + + + + + + + + + + + + + + + + + + + + + + + + + + + + + + + + + + + + + + + + + + + + + + + + + + + + ",
      "+ + + + + + + + + + + + + + + + + + + + + + + + + + + + + + + + + + + + + + + + + + + + + + + + + + + + + +",
      " + + + + + + + + + + + + + + + + + + + + + + + + + + + + + + + + + + + + + + + + + + + + + + + + + + + + + ",
      "+ + + + + + + + + + + + + + + + + + + + + + + + + + + + + + + + + + + + + + + + + + + + + + + + + + + + + +",
      " + + + + + + + + + + + + + + + + + + + + + + + + + + + + + + + + + + + + + + + + + + + + + + + + + + + + + ",
      "+ + + + + + + + + + + + + + + + + + + + + + + + + + + + + + + + + + + + + + + + + + + + + + + + + + + + + +",
      " + + + + + + + + + + + + + + + + + + + + + + + + + + + + + + + + + + + + + + + + + + + + + + + + + + + + + ",
      "+ + + + + + + + + + + + + + + + + + + + + + + + + + + + + + + + + + + + + + + + + + + + + + + + + + + + + +",
      " + + + + + + + + + + + + + + + + + + + + + + + + + + + + + + + + + + + + + + + + + + + + + + + + + + + + + ",
      "+ + + + + + + + + + + + + + + + + + + + + + + + + + + + + + + + + + + + + + + + + + + + + + + + + + + + + +",
      " + + + + + + + + + + + + + + + + + + + + + + + + + + + + + + + + + + + + + + + + + + + + + + + + + + + + + ",
      "+ + + + + + + + + + + + + + + + + + + + + + + + + + + + + + + + + + + + + + + + + + + + + + + + + + + + + +",
      " + + + + + + + + + + + + + + + + + + + + + + + + + + + + + + + + + + + + + + + + + + + + + + + + + + + + + ",
      "+ + + + + + + + + + + + + + + + + + + + + + + + + + + + + + + + + + + + + + + + + + + + + + + + + + + + + +",
      " + + + + + + + + + + + + + + + + + + + + + + + + + + + + + + + + + + + + + + + + + + + + + + + + + + + + + ",
      "+ + + + + + + + + + + + + + + + + + + + + + + + + + + + + + + + + + + + + + + + + + + + + + + + + + + + + +",
      " + + + + + + + + + + + + + + + + + + + + + + + + + + + + + + + + + + + + + + + + + + + + + + + + + + + + + ",
      "+ + + + + + + + + + + + + + + + + + + + + + + + + + + + + + + + + + + + + + + + + + + + + + + + + + + + + +",
      " + + + + + + + + + + + + + + + + + + + + + + + + + + + + + + + + + + + + + + + + + + + + + + + + + + + + + ",
      "+ + + + + + + + + + + + + + + + + + + + + + + + + + + + + + + + + + + + + + + + + + + + + + + + + + + + + +",
      " + + + + + + + + + + + + + + + + + + + + + + + + + + + + + + + + + + + + + + + + + + + + + + + + + + + + + ",
      "+ + + + + + + + + + + + + + + + + + + + + + + + + + + + + + + + + + + + + + + + + + + + + + + + + + + + + +",
      " + + + + + + + + + + + + + + + + + + + + + + + + + + + + + + + + + + + + + + + + + + + + + + + + + + + + + ",
      "+ + + + + + + + + + + + + + + + + + + + + + + + + + + + + + + + + + + + + + + + + + + + + + + + + + + + + +",
      " + + + + + + + + + + + + + + + + + + + + + + + + + + + + + + + + + + + + + + + + + + + + + + + + + + + + + "
    ]
  }
}