
{
  "ground": {
    "symbols": {
      "=" : {
        "class": "${default}.gamehex.staticitems.CustomStaticItem",
        "images": ["grounddirt"],
        "transform": "none",
        "passable": true,
        "buildable": true
      },
      "S" : {
        "class": "${default}.gamehex.staticitems.CustomStaticItem",
        "images": ["grounddirt", "sentinel"],
        "transform": "none",
        "passable": false
      },
      "&": {
        "class": "${default}.gamehex.staticitems.CustomStaticItem",
        "images": [
          "cliff-background-1/cliff-background-1-full"
        ],
        "id": "clifftop",
        "transform": "none",
        "passable": false
      },
      "Z": {
        "class": "${default}.gamehex.staticitems.AutoEdge",
        "innerTypeId": "clifftop",
        "background": "grounddirt",
        "innerBackgroundLocation": "cliff-background-1",
        "location": "cliff2"
      },
      "%" : {"class": "${default}.gamehex.staticitems.CustomStaticItem",
        "images": ["grounddirt"],
        "transform": "none",
        "passable": true,
        "buildable": true,
        "id": "cliffsand"},
      "X": {
        "class": "${default}.gamehex.staticitems.AutoEdge",
        "innerTypeId": "cliffsand",
        "background": "grounddirt",
        "location": "cliff2"
      }
    },
    "map": [
      "& & & & & & & & & & & & & & & & & & & & & & & & & & Z = = = = = = = = = = Z & & & & & & & & Z = = = = Z & &",
      " & & Z Z Z Z Z Z Z Z Z & & Z Z Z Z & & & & Z Z Z Z Z = = = = = = = = = = = Z Z Z Z Z & & & & Z = = = = Z Z ",
      "& & Z = = = = = = = = Z Z Z = = = Z & & & Z = = = = = = = = = = = = = = = = = = = = Z & & & Z Z = = = = = =",
      " & Z = = = = = = = = = = = = = = = Z & & Z = = = = = X X X = = = = = = = = = = = = Z & & & & & Z Z = = Z Z ",
      "& & Z = = = = = = = = = = = = = = = Z Z Z = = = = X X % % X = = X X X X = = = = = = Z Z Z & & & & Z = Z & &",
      " & & Z = = = = = = = = = = = = = = = = = = = = = X % % % % X X X % % % X = = = = = = = = Z & & & & Z Z & & ",
      "& & Z = = = = = = = = = = = Z Z = = = = = = = = X % % Z Z % % % % % % % X = = = = = = = = Z & & & & & & & &",
      " & Z = = = = = = = = = = = Z & Z = = = = = = = = X % Z & Z Z % % % % % % X = = = = = = = Z & & & & & & & & ",
      "& Z = = = = = = = = = = = Z & & Z = = = = = = = X % Z & & & Z % % X X % X = = = = = = = = Z & & & & & & & &",
      " & Z = = = = = = = = = = = Z & & Z = = = = = = = X % Z Z & & Z % X = X X = = = = = = = = = Z Z Z & & & & & ",
      "& & Z Z = = = = = = = = = = Z Z & Z Z = = = = = = X % % Z & Z % X = = = = = = = = = = = = = = = Z & & & & &",
      " & & & Z = = = = = = = = = = = Z & & Z = = = X X X % % Z & Z % % X X X X X = = = = = = = = = = = Z Z & & & ",
      "Z & & & Z = = = = = = = = = = = Z Z Z = = = X % % % % % Z Z % % % % % % % X = = = = = = = = = = = = Z & & &",
      " Z Z Z Z = = = = = = = = = = = = = = = = = X % % % % % % % % % % % % % % % X = = = = = = = = = = = = Z & & ",
      "= = = = = = = = = = = = = = = = = = = = = X % % % % % % % % % % % % % % % X = = = = = = = = = = = = = Z & &",
      " = = = = = = = = = = Z Z Z = = = = = = = = X % % S % % % % % % % % % % X X = = = = = = = = = = = = = Z & & ",
      "= = = = = = = = = = Z & & Z = = = = = = = = X X % % % % % % % X X % % X = = = = = = = = = = = = = = Z & & &",
      " = = = = = = = = Z Z & & Z = = = = = = = = = = X X X X % % % X = X % % X = = = = = = = = = = = = = Z & & Z ",
      "= = = = = = = Z Z & & & Z = Z Z Z = = = = = = = = = = X X X X = = X % X = = = = = = = = = = = = = Z & & Z =",
      " Z = = = = = Z & & & & & Z Z & & Z = = = = = = = = = = = = = = = = X X = = = = = = = = = = = = = Z & & Z = ",
      "& Z Z = = Z Z & Z Z Z Z & & & & Z = = = = = = = = = = = = = = = = = = = = = = = = = = = = = = = Z & & Z = =",
      " & & Z = Z & & Z = = = Z & & & & Z = = = = = = = = = = = = = = = = = = = = = = = = = = = = = = = Z & & Z = ",
      "& & & Z = Z & & Z Z = Z & & & & Z = = = = = = = = = = = = = = = = = = = = = = = = = = = = = = = Z & & Z = =",
      " & & Z = Z & & & & Z = Z Z & & Z = = = = = = = = = = = = = = = = = = = = = = = = = = = = = = = Z & & & Z = ",
      "& & & Z = Z Z Z & & Z = = Z & & Z = = = = = = = = = = = = = = = = = = = = = = = = = = = = = = = Z & & Z = =",
      " & & & Z = = = Z & Z = = Z & Z Z = = = = = = = = = = = = = = = = = = = = = = = = = = = = = = = = Z & & Z = ",
      "& & & & Z = = = Z Z = = Z & Z = = = = = = = = = = = = = = = = = = = = = = = = = = = = = = = = = = Z & Z = =",
      " & & Z Z = = = = = = = = Z Z = = = = = = = = = = = = = = = = = = = = = = = = = = = = = = = = Z Z Z & & Z Z ",
      "& & Z = = = = = = = = = = = = = = = = = = = = = = = = = = = = = = = = = = = = = = = = = = = Z & & & & & & &",
      " & Z = = = = = = = = = = = = = = = = = = = = = = = = = = = = = = = = = = = = = = = = = = = = Z & & & & & & ",
      "& Z = = = = = = = = = = = = = = = = = = = = = = = = = = = = = = = X X X X = = = = = = = = = = Z & Z Z & & &",
      " & Z = = = = = = = = = = = = = = = = = = X X X = = = = = = = = = X % % % X X = = = = = = = = = Z Z = Z & & ",
      "Z Z = = = = = = = = = = = = = = = = = = X % % X = = = = = = = = = X X X % % X X = = = = = = = = = = = Z & &",
      " = = = = = = = = = = = = = = = = = = = X % % X = = = = = = = = = = = = X X % % X = = = = = = = = = = = Z & ",
      "= = = = = = = = = = = = = = = = = = = = X % % X = = = = = = = = = = = = = X X X = = = = = = = = = = = Z & &",
      " = = = = = = = = = = = = = = = = = = = = X % % X = = = = = = = = = = = = = = = = = = = = = = = = = = = Z & ",
      "= = = = = = = = = = = = = = = = = = = = = X X X = = = = = = = = = = = = = = = = = = = = = = = = = = = = Z &",
      " = = = = = = = = = = = = = = = = = = = = = = = = = = = = = = = = = = = = = = = = = = = = = = = = = = = = Z ",
      "= = = = = = = = = = = = = = = = = = = = = = = = = = = = = = = = = = = = = = = = = = = = = = = = = = = = = =",
      " = = = = = = = = = = = = = = = = = X X X = = = = = = = = = = = = = = = = = = = = = = = = = = = = = = = = = ",
      "= = = = = = = = = = = = = = = = = X % % X = = = = = = = X X X = = = = = = = = = = = = = = = = = = = = = = =",
      " = = = = = = = = = = = = = = = = X % % X = = = = X X = X % % X X X X = = = = = = = = = = = = = = = = = = = ",
      "= = = = = = = = = = = = = = = = = X % X = = = = X % X X % % % % % % X = = = = = = = = = = = = = = = = = = =",
      " = = = = = = = = = = = = = X X = = X % X = X X X % % % % Z Z Z Z % % X = = = = = = = = = = = = = = = = = = ",
      "= = = = = = = = = = = = = X % X X X % % X X % % % % % Z Z & & & Z % % X X = = = = = = = = = = = = = = = = =",
      " = = = = = = = = = = = = X % % % % % % % % % % % % % Z & & & & & Z % % % X = = = = = = = = = = = = = = = = "
    ]
  },
  "other": {
    "symbols": {
      "W" : {"class": "${default}.gamehex.other.Fire"},
      "/" : {"class": "${default}.gamehex.other.DeadFirePlant"},
      "§" : {"class": "${default}.gamehex.other.LiveFirePlant"},
      "O" : {"class": "${default}.gamehex.other.Boulder"},
      "&" : {"class": "${default}.gamehex.other.Brick"},
      "%" : {
        "class": "${default}.gamehex.other.DroppedItemInteractor",
        "imageName": "driedPlantItem/driedPlantItem",
        "passable": true,
        "itemType": "avividi.com.monuments.controller.item.DriedPlantItem"

      }
    },
    "map": [
      "+ + + + + + + + + + + + + + + + + + + + + + + + + + + § / / + + + + + + + + + + + + + + + + + + + + + + + +",
      " + + + + + + + + + + + + + + + + + + + + + + + + + + § / + + + + + + + + + + + + + + + + + + + + + / + + + ",
      "+ + + / + + + + + + + + + + + + + + + + + + + + + + + + + + + + + + + + + + + + + + + + + + + + + + + + + +",
      " + + / / + + + + + + + + + + + + + + + + + + + + + + + + + + + + + + + + + + + + + + + + + + + + + + + + + ",
      "+ + + + + + + + + + + + + + + + + + + + + + + + + + + + + + + + + + + + + + + + + + + + + + + + + + + + + +",
      " + + + + + + + + + + + + + + + + + + + + + + + + + + + + / + + + + + + + + + + + + + + + + + + + + + + + + ",
      "+ + + + + + + % % % + + + + + + + + + + + + + + + + + + + + + + + + + + + + + + + + + + + + + + + + + + + +",
      " + + + + + + % % % + + + + + + + + + + + + + + + + + + + + + + + + + + + + + + + + + + + + + + + + + + + + ",
      "+ + + + + + + + + + + + + + + + + + + + + + + + + + + + + + + + + + + + + + + + + + + + + + + + + + + + + +",
      " + + § § + + + + + + + + + + + + + + + + + + + + + + + + + + + + + + + + + + + + + + + + + + + + + + + + + ",
      "+ + + + + + + + + + + + + + + + + + + + + + + + + + / + + + + + + + + + + + + + + + + + + + + + + + + + + +",
      " + + + + + + + + + + + + + + + + + + + + + + + + + + + + + + + + + + + + + + + + + + + + + + + + + + + + + ",
      "+ + + + + + + + + + + + + + + § + + + + + + + + + + + + + + + + + + + + + + + + + + + + + + + + + + + + + +",
      " + + + + + + + + + + + + + + + + + + + + § + + + + + + + + + + + + + + + + + + + + + + + + + + + + + + + + ",
      "+ + + + + + + + + + + + + + + + + + + + + + + + + + + + + + + + + + + + + + + + + § § + + + + + + + + + + +",
      " + + + + + + + + + + + + + § + + + + + + + + + + + + + + + + + + + + + + + + + + + + § + + + + + + + + + + ",
      "+ + + + + + + + + + + + + + + + + + + + + + + + + + + + + + + + + + + + + + + + + + + + + + + + + + + + + +",
      " + + + + + + + + + + + + + + + + + + + + + + + + + + + + + + + + + + + + + + + + + + + + + + + + + + + + + ",
      "+ + § + + + + + + + + + + § + + + + + + + + + + + + + + + + + + + + + + + + + + + + + + + + + + + + + + + +",
      " + + + + + + + + + + + + + + + + + + + + + + + + + + + + + + + + + + + + + + + + + § + + + + + + + + + + + ",
      "+ + + + + + + + + + + + + + + + + + + + + + + + + + + + + § + + + + + + + + + + + + + + + + + + + + + + + +",
      " + + + + + + + + / / § + + + + + + + + + + + + + + + + + + + § + + + + + + + + + + + + + + + + + + + + + + ",
      "+ + + + + + + + + + § + + + + + + + + + + + + + + + + § § + + + + + + + + + + + + + + + + + + + + + + + + +",
      " + + + + + + + + + + + + + + + + + + + + + + + + + + § § + + + + + + + + + + + + + + + + + + + + + + + + + ",
      "+ + + + + + + + + + + + + + + + + + + + + + + + + + + + + + + + + + + + + + + + + + + + + + + + + + + + + +",
      " + + + + + + + + + + + + + + + + + + + + + + + + + + + + + + + + + + + + + + + + + + + + + + + + + + + + + ",
      "+ + + + + + + + + + + + + + + + + + + + + + + + + + + + + + + + + + + + + + + + + + + + + + + + + + + + + +",
      " + + + + + + + + + + + + + + + + + + + + + + + + + + + + + + + + + + + + + + + + + + + + + + + + + + + + + ",
      "+ + + + + + + + + + + + + + + + + + + + + + + + + + + + + + + + + + + + + + + + + + + + + + + + + + + + + +",
      " + + + + + + + + + + + + + + + + + + + + + + + + + + + + + + + + + + + + + + + + + + + + + + + + + + + + + ",
      "+ + + + + + + + + + + + + + + + + + + + + + + + + + + + + + + + + + + + + + + + + + + + + + + + + + + + + +",
      " + + + + + + + + + + + + + + + + + + + + + + + + + + + + + + + + + + + + + + + + + + + + + + + + + + + + + ",
      "+ + + + + + + + + + + + + / + + + + + + + + + + + + + + + + + + + + + + + / + + + + + + + + + + + + + + + +",
      " + + + + + + + + + + + + + + + + + + + + + + + + + + + + + + + + + + + + + + + + + + + + + + + + + + + + + ",
      "+ + + + + + + + + § § / + + + + + + + + + + + + + + + + + + + + + + + + + + + + + + + + + + + + + + + + + +",
      " + + + + + + + + + § § + + + + + + + + + + + + + + + + + + + + + + + + + + + + + + + + + + + + + + + + + + ",
      "/ + + + + + + + + + § + + + + + + + + + + + + + + + + + + + + + + + + + + + + + + + + + + + + + + + + + + +",
      " + + + + + + + + + + + + + + + + + + + + + + + + + + + + + + + + + + + + + + + + + + + § + + + + + + + + + ",
      "+ + + + + + + + + + + + + + + + + + + + + + + + + + + + + + + + + + + + + + + + + + + + + + + + + + + + + +",
      " + + + + + + + + + + + + + + + + + + + + + + + § § + + + + + + + + + + + + + § + + + + + + + + + + + + + + ",
      "+ + + + § + + + + + + + + + + + + + + + + + + + § § + + + + + + + + + + + + + + + + + § + + + + + + + + + +",
      " + + § § § § § + + + + + + + + + + + + + + + + + + + + + + + + + + + + + + + + + + + + + + + + + + + + + + ",
      "+ + + § § § + § + + + + + + + + + + + + + + + + + + + + + + + + + + + + + + § + + + + + + + + + + + + + + +",
      " + + + + § § § + + + + + + + + + + + + + + + + + + + + + + + + + + + + + + § § + § § § + + + + + + + + + + ",
      "+ + + + § + + + + + + + + + + + + + + + + + + + + + + + + + + + + + + + + + § / § § § / + + + § + + + + + +",
      " + + + § + + + + + + + + + + + + + + + + + + + + + + + + + + + + + + + + + § + § § + § + + + + + + + + + + "
    ]
  },
  "units": {
    "symbols": {
      "S" : {"class": "${default}.gamehex.unit.Maldar"},
      "U" : {"class": "${default}.gamehex.unit.Rivskin"}
    },
    "map": [
      "+ + + + + + + + + + + + + + + + + + + + + + + + + + + + + + + + + + + + + + + + + + + + + + + + + + + + + +",
      " + + + + + + + + + + + + + + + + + + + + + + + + + + + + + + + + + + + + + + + + + + + + + + + + + + + + + ",
      "+ + + + + + + + + + + + + + + + + + + + + + + + + + + + + + + + + + + + + + + + + + + + + + + + + + + + + +",
      " + + + + + + + + + + + + + + + + + + + + + + + + + + + + + + + + + + + + + + + + + + + + + + + + + + + + + ",
      "+ + + + + + + + + + + + + + + + + + + + + + + + + + + + + + + + + + + + + + + + + + + + + + + + + + + + + +",
      " + + + + + + + + + + + + + + + + + + + + + + + + + + + + + + + + + + + + + + + + + + + + + + + + + + + + + ",
      "+ + + + + + + + + + + + + + + + + + + + + + + + + + + + + + + + + + + + + + + + + + + + + + + + + + + + + +",
      " + + + + + + + + + + + + + + + + + + + + + + + + + + + + + + + + + + + + + + + + + + + + + + + + + + + + + ",
      "+ + + + + + + + + + + + + + + + + + + + + + + + + + + + + + + + + + + + + + + + + + + + + + + + + + + + + +",
      " + + + + + + + + + S + + + + + + + + + + + + + + + + + + + + + + + + + + + + + + + + + + + + + + + + + + + ",
      "+ + + + + + + + + + + + + + + + + + + + + + + + + + + + + + + + + + + + + + + + + + + + + + + + + + + + + +",
      " + + + + + + + + + + + + + + + + + + + + + + + + + + + + + + + + + + + + + + + + + + + + + + + + + + + + + ",
      "+ + + + + + + + + + + + + + + + + + + + + + + + + + + + + + + + + + + + + + + + + + + + + + + + + + + + + +",
      " + + + + + + + + + + + + + + + + + + + + + + + + + + + + + + + + + + + + + + + + + + + + + + + + + + + + + ",
      "+ + + + + + + + + + + + + + + + + + + + + + + + + + + + + + + + + + + + + + + + + + + + + + + + + + + + + +",
      " + + + + + + + + + + + + + + + + + + + + + + + + + + + + + + + + + + + + + + + + + + + + + + + + + + + + + ",
      "+ + + + + + + + + + + + + + + + + + + + + + + + + + + + + + + + + + + + + + + + + + + + + + + + + + + + + +",
      " + + + + + + + + + + + + + + + + + + + + + + + + + + + + + + + + + + + + + + + + + + + + + + + + + + + + + ",
      "+ + + + + + + + + + + + + + + + + + + + + + + + + + + + + + + + + + + + + + + + + + + + + + + + + + + + + +",
      " + + + + + + + + + + + + + + + + + + + + + + + + + + + + + + + + + + + + + + + + + + + + + + + + + + + + + ",
      "+ + + + + + + + + + + + + + + + + + + + + + + + + + + + + + + + + + + + + + + + + + + + + + + + + + + + + +",
      " + + + + + + + + + + + + + + + + + + + + + + + + + + + + + + + + + + + + + + + + + + + + + + + + + + + + + ",
      "+ + + + + + + + + + + + + + + + + + + + + + + + + + + + + + + + + + + + + + + + + + + + + + + + + + + + + +",
      " + + + + + + + + + + + + + + + + + + + + + + + + + + + + + + + + + + + + + + + + + + + + + + + + + + + + + ",
      "+ + + + + + + + + + + + + + + + + + + + + + + + + + + + + + + + + + + + + + + + + + + + + + + + + + + + + +",
      " + + + + + + + + + + + + + + + + + + + + + + + + + + + + + + + + + + + + + + + + + + + + + + + + + + + + + ",
      "+ + + + + + + + + + + + + + + + + + + + + + + + + + + + + + + + + + + + + + + + + + + + + + + + + + + + + +",
      " + + + + + + + + + + + + + + + + + + + + + + + + + + + + + + + + + + + + + + + + + + + + + + + + + + + + + ",
      "+ + + + + + + + + + + + + + + + + + + + + + + + + + + + + + + + + + + + + + + + + + + + + + + + + + + + + +",
      " + + + + + + + + + + + + + + + + + + + + + + + + + + + + + + + + + + + + + + + + + + + + + + + + + + + + + ",
      "+ + + + + + + + + + + + + + + + + + + + + + + + + + + + + + + + + + + + + + + + + + + + + + + + + + + + + +",
      " + + + + + + + + + + + + + + + + + + + + + + + + + + + + + + + + + + + + + + + + + + + + + + + + + + + + + ",
      "+ + + + + + + + + + + + + + + + + + + + + + + + + + + + + + + + + + + + + + + + + + + + + + + + + + + + + +",
      " + + + + + + + + + + + + + + + + + + + + + + + + + + + + + + + + + + + + + + + + + + + + + + + + + + + + + ",
      "+ + + + + + + + + + + + + + + + + + + + + + + + + + + + + + + + + + + + + + + + + + + + + + + + + + + + + +",
      " + + + + + + + + + + + + + + + + + + + + + + + + + + + + + + + + + + + + + + + + + + + + + + + + + + + + + ",
      "+ + + + + + + + + + + + + + + + + + + + + + + + + + + + + + + + + + + + + + + + + + + + + + + + + + + + + +",
      " + + + + + + + + + + + + + + + + + + + + + + + + + + + + + + + + + + + + + + + + + + + + + + + + + + + + + ",
      "+ + + + + + + + + + + + + + + + + + + + + + + + + + + + + + + + + + + + + + + + + + + + + + + + + + + + + +",
      " + + + + + + + + + + + + + + + + + + + + + + + + + + + + + + + + + + + + + + + + + + + + + + + + + + + + + ",
      "+ + + + + + + + + + + + + + + + + + + + + + + + + + + + + + + + + + + + + + + + + + + + + + + + + + + + + +",
      " + + + + + + + + + + + + + + + + + + + + + + + + + + + + + + + + + + + + + + + + + + + + + + + + + + + + + ",
      "+ + + + + + + + + + + + + + + + + + + + + + + + + + + + + + + + + + + + + + + + + + + + + + + + + + + + + +",
      " + + + + + + + + + + + + + + + + + + + + + + + + + + + + + + + + + + + + + + + + + + + + + + + + + + + + + ",
      "+ S + + + + + + + + + + + + + + + + + + + + + + + + + + + + + + + + + + + + + + + + + + + + + + + + + + + +",
      " + + + + + + + + + + + + + + + + + + + + + + + + + + + + + + + + + + + + + + + + + + + + + + + + + S + + + "
    ]
  }
}