
{
  "ground": {
    "symbols": {
      "=" : {"class": "${default}.gamehex.staticitems.Ground"}
    },
    "map": [
      "= = = = = = = = = = = = = = = = = = = = = = = = = = =",
      " = = = = = = = = = = = = = = = = = = = = = = = = = = ",
      "= = = = = = = = = = = = = = = = = = = = = = = = = = =",
      " = = = = = = = = = = = = = = = = = = = = = = = = = = ",
      "= = = = = = = = = = = = = = = = = = = = = = = = = = =",
      " = = = = = = = = = = = = = = = = = = = = = = = = = = ",
      "= = = = = = = = = = = = = = = = = = = = = = = = = = =",
      " = = = = = = = = = = = = = = = = = = = = = = = = = = ",
      "= = = = = = = = = = = = = = = = = = = = = = = = = = =",
      " = = = = = = = = = = = = = = = = = = = = = = = = = = ",
      "= = = = = = = = = = = = = = = = = = = = = = = = = = =",
      " = = = = = = = = = = = = = = = = = = = = = = = = = = ",
      "= = = = = = = = = = = = = = = = = = = = = = = = = = =",
      " = = = = = = = = = = = = = = = = = = = = = = = = = = ",
      "= = = = = = = = = = = = = = = = = = = = = = = = = = =",
      " = = = = = = = = = = = = = = = = = = = = = = = = = = ",
      "= = = = = = = = = = = = = = = = = = = = = = = = = = =",
      " = = = = = = = = = = = = = = = = = = = = = = = = = = ",
      "= = = = = = = = = = = = = = = = = = = = = = = = = = =",
      " = = = = = = = = = = = = = = = = = = = = = = = = = = ",
      "= = = = = = = = = = = = = = = = = = = = = = = = = = =",
      " = = = = = = = = = = = = = = = = = = = = = = = = = = "
    ]
  },
  "other": {
    "symbols": {
      "W" : {"class": "${default}.gamehex.other.Fire"},
      "§" : {"class": "${default}.gamehex.other.DeadFirePlant"},
      "#" : {"class": "${default}.gamehex.other.Brick"}
    },
    "map": [
      "§ § § + + + + + + + + + + + § + + + + + + + + + + + +",
      " § + + + + + + + + + + + + § § + + + + + + + + + + + ",
      "§ § § + + + + + + + + + + + + + + + + + + + + + + + +",
      " + § + + + + + + + + + + + + § + + + + + + + + + + + ",
      "§ § + § + § + + # # + + + + + + + + + + + + + + + + +",
      " § + + + + + + + + + + + + + + + + + + + + + + + + + ",
      "§ + + + + + § + + + + + + § + + + + + + + + + + § + +",
      " § + + + + + + + W W + + + + + + + + + + + + + + + + ",
      "§ + + + + + + + W + W + + + + + + + + + + + + + + + +",
      " + § # + + + + + W W + + + § + + § § + + + + + + + + ",
      "+ + # + + + + + + + + + + § § + + + § + + + + + + + +",
      " + + + + + + + + + + + + + + + + + + + + + + + + + + ",
      "+ + + + + + + + + + + + + + + + + + + + + + + + + + +",
      " + + + + # + + + + + + § + + + + § + + + + + + + + + ",
      "+ + + § + + + + + § + + + + + + + + + + + + + § + § +",
      " + + + + + + + + + + + + + W + + + + + + + + + + § § ",
      "+ + + + + + + + + + + + + W W + + + + + + + § + § + §",
      " + + + + + + + + + + + + + W + + + + + + + + + § § § ",
      "+ + + + + + + + + + + + + + + + + + + + + + + § § § §",
      " + + + + + + + + + + + + + + + + + + + + + + + + + § ",
      "+ + + + + + + + + + + + + § § + + + + + + + + + § + +",
      " + + § § + + + + + + § § § § § § § § + + + + + + + + "
    ]
  },
  "units": {
    "symbols": {
      "S" : {"class": "${default}.gamehex.unit.Maldar"}
    },
    "map": [
      "+ + + + + + + + + + + + + + + + + + + + + + + + + + +",
      " + + + + + + + + + + + + + + + + + + + + + + + + + + ",
      "+ + + + + + + + + + + + + + + + + + + + + + + + + + +",
      " + + + + + + + + + + + S + + + + + + + + + + + + + + ",
      "+ + + + + + + + + + + + + + + + + + + + + + + + + + +",
      " + + + + + + + + + + + + + + + + + + + + + + + + + + ",
      "+ + + + + + + + + + + + + + + + + + + + + + + + + + +",
      " + + + + + + + + + + + + + + + + + + + + + + + + + + ",
      "+ + + + + + + + + + + + + + + + + + + + + S + + + + +",
      " + + + + + + S + + + + + + + + + + + + + + S + + + + ",
      "+ + + + + + S + + + + + + + + + + + + + + + + + + + +",
      " + + + + + S + + + + + + + + + + + + + + + + + + + + ",
      "+ + + + + S + + + + + + + + + + + + + + + + + + + + +",
      " + + + + S + + + + + + + + + + + + + + + + + + + + + ",
      "+ + + + S S + + + + + + + + + + + + + + + + + + + + +",
      " + + + S S S + + + + + + + + + + + + + + + + + + + + ",
      "+ + + + S S + + + + + + + + + + + + + + + + + + + + +",
      " + + + + + S + + + + + + + + + + + + + + + + + + + + ",
      "+ + + + + + + + + + + + + + + + + + + + + + + + + + +",
      " + + + + + + + + + + + + + + + + + + + + + + + + + + ",
      "+ + + + + + + + + + + + + S + + + + + + + + + + + + +",
      " + + + + + + + + + + + + + + + + + + + + + + + + + S "
    ]
  }
}